Detector Type, Dexcriptor Type, Image No., No. of Matched Keypoints, Time Detector, Time Descriptor, Time Total
SHITOMASI, BRISK, 1, 95, 13, 191, 204
SHITOMASI, BRISK, 2, 88, 17, 192, 209
SHITOMASI, BRISK, 3, 80, 13, 194, 207
SHITOMASI, BRISK, 4, 90, 13, 193, 206
SHITOMASI, BRISK, 5, 82, 13, 191, 204
SHITOMASI, BRISK, 6, 79, 11, 190, 201
SHITOMASI, BRISK, 7, 85, 8, 190, 198
SHITOMASI, BRISK, 8, 86, 13, 192, 205
SHITOMASI, BRISK, 9, 82, 13, 191, 204
SHITOMASI, BRIEF, 1, 115, 13, 0, 13
SHITOMASI, BRIEF, 2, 111, 12, 1, 13
SHITOMASI, BRIEF, 3, 104, 10, 0, 10
SHITOMASI, BRIEF, 4, 101, 11, 0, 11
SHITOMASI, BRIEF, 5, 102, 11, 0, 11
SHITOMASI, BRIEF, 6, 102, 10, 0, 10
SHITOMASI, BRIEF, 7, 100, 11, 0, 11
SHITOMASI, BRIEF, 8, 109, 11, 0, 11
SHITOMASI, BRIEF, 9, 100, 11, 0, 11
SHITOMASI, ORB, 1, 104, 11, 3, 14
SHITOMASI, ORB, 2, 103, 13, 2, 15
SHITOMASI, ORB, 3, 100, 10, 3, 13
SHITOMASI, ORB, 4, 102, 12, 3, 15
SHITOMASI, ORB, 5, 103, 11, 3, 14
SHITOMASI, ORB, 6, 98, 11, 3, 14
SHITOMASI, ORB, 7, 98, 11, 3, 14
SHITOMASI, ORB, 8, 102, 11, 3, 14
SHITOMASI, ORB, 9, 97, 11, 3, 14
SHITOMASI, FREAK, 1, 86, 10, 30, 40
SHITOMASI, FREAK, 2, 90, 10, 31, 41
SHITOMASI, FREAK, 3, 86, 13, 34, 47
SHITOMASI, FREAK, 4, 88, 13, 30, 43
SHITOMASI, FREAK, 5, 86, 12, 30, 42
SHITOMASI, FREAK, 6, 80, 13, 29, 42
SHITOMASI, FREAK, 7, 81, 10, 29, 39
SHITOMASI, FREAK, 8, 86, 10, 29, 39
SHITOMASI, FREAK, 9, 85, 13, 29, 42
SHITOMASI, SIFT, 1, 112, 13, 13, 26
SHITOMASI, SIFT, 2, 109, 11, 18, 29
SHITOMASI, SIFT, 3, 104, 14, 15, 29
SHITOMASI, SIFT, 4, 103, 15, 26, 41
SHITOMASI, SIFT, 5, 99, 16, 20, 36
SHITOMASI, SIFT, 6, 101, 15, 20, 35
SHITOMASI, SIFT, 7, 96, 15, 15, 30
SHITOMASI, SIFT, 8, 106, 15, 18, 33
SHITOMASI, SIFT, 9, 97, 14, 23, 37
HARRIS, BRISK, 1, 10, 17, 248, 265
HARRIS, BRISK, 2, 11, 13, 209, 222
HARRIS, BRISK, 3, 14, 11, 210, 221
HARRIS, BRISK, 4, 13, 15, 206, 221
HARRIS, BRISK, 5, 14, 15, 200, 215
HARRIS, BRISK, 6, 14, 10, 194, 204
HARRIS, BRISK, 7, 16, 15, 192, 207
HARRIS, BRISK, 8, 20, 14, 192, 206
HARRIS, BRISK, 9, 17, 13, 190, 203
HARRIS, BRIEF, 1, 10, 11, 0, 11
HARRIS, BRIEF, 2, 13, 10, 0, 10
HARRIS, BRIEF, 3, 15, 13, 0, 13
HARRIS, BRIEF, 4, 15, 12, 0, 12
HARRIS, BRIEF, 5, 20, 12, 0, 12
HARRIS, BRIEF, 6, 17, 12, 0, 12
HARRIS, BRIEF, 7, 16, 11, 0, 11
HARRIS, BRIEF, 8, 22, 13, 0, 13
HARRIS, BRIEF, 9, 18, 12, 0, 12
HARRIS, ORB, 1, 10, 14, 5, 19
HARRIS, ORB, 2, 13, 16, 4, 20
HARRIS, ORB, 3, 16, 12, 4, 16
HARRIS, ORB, 4, 17, 14, 3, 17
HARRIS, ORB, 5, 18, 17, 3, 20
HARRIS, ORB, 6, 16, 16, 3, 19
HARRIS, ORB, 7, 17, 13, 3, 16
HARRIS, ORB, 8, 21, 18, 4, 22
HARRIS, ORB, 9, 18, 16, 3, 19
HARRIS, FREAK, 1, 9, 10, 29, 39
HARRIS, FREAK, 2, 13, 15, 34, 49
HARRIS, FREAK, 3, 14, 9, 28, 37
HARRIS, FREAK, 4, 14, 11, 29, 40
HARRIS, FREAK, 5, 14, 11, 31, 42
HARRIS, FREAK, 6, 14, 13, 29, 42
HARRIS, FREAK, 7, 12, 13, 28, 41
HARRIS, FREAK, 8, 20, 13, 32, 45
HARRIS, FREAK, 9, 18, 13, 33, 46
HARRIS, SIFT, 1, 10, 13, 19, 32
HARRIS, SIFT, 2, 13, 15, 16, 31
HARRIS, SIFT, 3, 17, 15, 17, 32
HARRIS, SIFT, 4, 15, 15, 15, 30
HARRIS, SIFT, 5, 19, 13, 13, 26
HARRIS, SIFT, 6, 17, 11, 14, 25
HARRIS, SIFT, 7, 14, 14, 19, 33
HARRIS, SIFT, 8, 23, 15, 13, 28
HARRIS, SIFT, 9, 19, 16, 18, 34
FAST, BRISK, 1, 256, 2, 250, 252
FAST, BRISK, 2, 243, 1, 220, 221
FAST, BRISK, 3, 241, 2, 217, 219
FAST, BRISK, 4, 239, 2, 225, 227
FAST, BRISK, 5, 215, 2, 219, 221
FAST, BRISK, 6, 251, 2, 239, 241
FAST, BRISK, 7, 248, 2, 263, 265
FAST, BRISK, 8, 243, 2, 259, 261
FAST, BRISK, 9, 247, 2, 263, 265
FAST, BRIEF, 1, 320, 2, 3, 5
FAST, BRIEF, 2, 332, 1, 2, 3
FAST, BRIEF, 3, 299, 2, 2, 4
FAST, BRIEF, 4, 331, 2, 3, 5
FAST, BRIEF, 5, 276, 2, 1, 3
FAST, BRIEF, 6, 327, 3, 4, 7
FAST, BRIEF, 7, 324, 2, 3, 5
FAST, BRIEF, 8, 315, 2, 4, 6
FAST, BRIEF, 9, 307, 3, 3, 6
FAST, ORB, 1, 306, 2, 4, 6
FAST, ORB, 2, 314, 3, 5, 8
FAST, ORB, 3, 295, 3, 5, 8
FAST, ORB, 4, 318, 3, 4, 7
FAST, ORB, 5, 284, 2, 6, 8
FAST, ORB, 6, 312, 2, 7, 9
FAST, ORB, 7, 323, 2, 5, 7
FAST, ORB, 8, 306, 2, 5, 7
FAST, ORB, 9, 304, 2, 6, 8
FAST, FREAK, 1, 251, 2, 46, 48
FAST, FREAK, 2, 247, 3, 40, 43
FAST, FREAK, 3, 233, 3, 45, 48
FAST, FREAK, 4, 255, 2, 40, 42
FAST, FREAK, 5, 231, 3, 43, 46
FAST, FREAK, 6, 265, 2, 38, 40
FAST, FREAK, 7, 251, 2, 44, 46
FAST, FREAK, 8, 253, 1, 45, 46
FAST, FREAK, 9, 247, 3, 40, 43
FAST, SIFT, 1, 316, 2, 29, 31
FAST, SIFT, 2, 325, 2, 35, 37
FAST, SIFT, 3, 297, 2, 30, 32
FAST, SIFT, 4, 311, 2, 31, 33
FAST, SIFT, 5, 291, 1, 27, 28
FAST, SIFT, 6, 326, 2, 35, 37
FAST, SIFT, 7, 315, 3, 37, 40
FAST, SIFT, 8, 300, 2, 33, 35
FAST, SIFT, 9, 301, 2, 29, 31
BRISK, BRISK, 1, 171, 240, 200, 440
BRISK, BRISK, 2, 176, 227, 212, 439
BRISK, BRISK, 3, 157, 260, 224, 484
BRISK, BRISK, 4, 176, 250, 197, 447
BRISK, BRISK, 5, 174, 227, 205, 432
BRISK, BRISK, 6, 188, 236, 209, 445
BRISK, BRISK, 7, 173, 236, 205, 441
BRISK, BRISK, 8, 171, 249, 216, 465
BRISK, BRISK, 9, 184, 277, 224, 501
BRISK, BRIEF, 1, 178, 284, 1, 285
BRISK, BRIEF, 2, 205, 251, 0, 251
BRISK, BRIEF, 3, 185, 243, 1, 244
BRISK, BRIEF, 4, 179, 250, 0, 250
BRISK, BRIEF, 5, 183, 247, 0, 247
BRISK, BRIEF, 6, 195, 248, 1, 249
BRISK, BRIEF, 7, 207, 243, 1, 244
BRISK, BRIEF, 8, 189, 249, 0, 249
BRISK, BRIEF, 9, 183, 264, 1, 265
BRISK, ORB, 1, 160, 245, 11, 256
BRISK, ORB, 2, 171, 238, 11, 249
BRISK, ORB, 3, 157, 230, 11, 241
BRISK, ORB, 4, 170, 245, 11, 256
BRISK, ORB, 5, 154, 254, 12, 266
BRISK, ORB, 6, 180, 228, 10, 238
BRISK, ORB, 7, 171, 223, 11, 234
BRISK, ORB, 8, 175, 232, 11, 243
BRISK, ORB, 9, 172, 245, 10, 255
BRISK, FREAK, 1, 160, 267, 32, 299
BRISK, FREAK, 2, 177, 226, 30, 256
BRISK, FREAK, 3, 155, 232, 29, 261
BRISK, FREAK, 4, 173, 223, 30, 253
BRISK, FREAK, 5, 161, 224, 30, 254
BRISK, FREAK, 6, 183, 224, 30, 254
BRISK, FREAK, 7, 169, 258, 30, 288
BRISK, FREAK, 8, 178, 248, 33, 281
BRISK, FREAK, 9, 168, 230, 32, 262
BRISK, SIFT, 1, 182, 228, 24, 252
BRISK, SIFT, 2, 193, 238, 29, 267
BRISK, SIFT, 3, 169, 250, 26, 276
BRISK, SIFT, 4, 183, 224, 26, 250
BRISK, SIFT, 5, 171, 232, 24, 256
BRISK, SIFT, 6, 195, 221, 25, 246
BRISK, SIFT, 7, 194, 223, 25, 248
BRISK, SIFT, 8, 176, 222, 25, 247
BRISK, SIFT, 9, 183, 225, 25, 250
ORB, BRISK, 1, 73, 6, 203, 209
ORB, BRISK, 2, 74, 5, 199, 204
ORB, BRISK, 3, 79, 5, 196, 201
ORB, BRISK, 4, 85, 5, 193, 198
ORB, BRISK, 5, 79, 6, 197, 203
ORB, BRISK, 6, 92, 6, 196, 202
ORB, BRISK, 7, 90, 7, 199, 206
ORB, BRISK, 8, 88, 7, 223, 230
ORB, BRISK, 9, 91, 5, 196, 201
ORB, BRIEF, 1, 49, 6, 0, 6
ORB, BRIEF, 2, 43, 7, 0, 7
ORB, BRIEF, 3, 45, 7, 0, 7
ORB, BRIEF, 4, 59, 6, 0, 6
ORB, BRIEF, 5, 53, 7, 0, 7
ORB, BRIEF, 6, 78, 9, 1, 10
ORB, BRIEF, 7, 68, 9, 1, 10
ORB, BRIEF, 8, 84, 7, 2, 9
ORB, BRIEF, 9, 66, 8, 0, 8
ORB, ORB, 1, 65, 6, 15, 21
ORB, ORB, 2, 69, 6, 15, 21
ORB, ORB, 3, 71, 7, 15, 22
ORB, ORB, 4, 85, 8, 12, 20
ORB, ORB, 5, 91, 11, 12, 23
ORB, ORB, 6, 101, 8, 15, 23
ORB, ORB, 7, 95, 8, 14, 22
ORB, ORB, 8, 93, 9, 14, 23
ORB, ORB, 9, 91, 9, 18, 27
ORB, FREAK, 1, 42, 9, 37, 46
ORB, FREAK, 2, 36, 7, 36, 43
ORB, FREAK, 3, 44, 9, 36, 45
ORB, FREAK, 4, 47, 7, 36, 43
ORB, FREAK, 5, 44, 10, 36, 46
ORB, FREAK, 6, 51, 9, 39, 48
ORB, FREAK, 7, 52, 8, 43, 51
ORB, FREAK, 8, 48, 8, 40, 48
ORB, FREAK, 9, 56, 10, 38, 48
AKAZE, AKAZE, 1, 138, 99, 73, 172
AKAZE, AKAZE, 2, 138, 87, 68, 155
AKAZE, AKAZE, 3, 133, 77, 60, 137
AKAZE, AKAZE, 4, 127, 92, 77, 169
AKAZE, AKAZE, 5, 129, 88, 74, 162
AKAZE, AKAZE, 6, 146, 86, 68, 154
AKAZE, AKAZE, 7, 147, 76, 42, 118
AKAZE, AKAZE, 8, 151, 64, 48, 112
AKAZE, AKAZE, 9, 150, 53, 43, 96
SIFT, BRISK, 1, 64, 95, 182, 277
SIFT, BRISK, 2, 66, 98, 184, 282
SIFT, BRISK, 3, 62, 96, 179, 275
SIFT, BRISK, 4, 66, 97, 179, 276
SIFT, BRISK, 5, 59, 95, 178, 273
SIFT, BRISK, 6, 64, 96, 178, 274
SIFT, BRISK, 7, 64, 95, 179, 274
SIFT, BRISK, 8, 67, 103, 180, 283
SIFT, BRISK, 9, 80, 93, 182, 275
SIFT, BRIEF, 1, 86, 97, 0, 97
SIFT, BRIEF, 2, 78, 95, 0, 95
SIFT, BRIEF, 3, 76, 97, 0, 97
SIFT, BRIEF, 4, 85, 97, 0, 97
SIFT, BRIEF, 5, 69, 97, 0, 97
SIFT, BRIEF, 6, 74, 97, 0, 97
SIFT, BRIEF, 7, 76, 96, 0, 96
SIFT, BRIEF, 8, 70, 95, 0, 95
SIFT, BRIEF, 9, 88, 97, 0, 97
SIFT, FREAK, 1, 65, 93, 30, 123
SIFT, FREAK, 2, 72, 96, 30, 126
SIFT, FREAK, 3, 64, 92, 28, 120
SIFT, FREAK, 4, 66, 92, 29, 121
SIFT, FREAK, 5, 59, 105, 34, 139
SIFT, FREAK, 6, 59, 97, 29, 126
SIFT, FREAK, 7, 64, 97, 29, 126
SIFT, FREAK, 8, 65, 96, 30, 126
SIFT, FREAK, 9, 79, 115, 30, 145
SIFT, SIFT, 1, 82, 106, 77, 183
SIFT, SIFT, 2, 81, 97, 62, 159
SIFT, SIFT, 3, 85, 89, 69, 158
SIFT, SIFT, 4, 93, 89, 65, 154
SIFT, SIFT, 5, 90, 86, 63, 149
SIFT, SIFT, 6, 81, 81, 65, 146
SIFT, SIFT, 7, 82, 80, 63, 143
SIFT, SIFT, 8, 102, 95, 63, 158
SIFT, SIFT, 9, 104, 86, 66, 152
